b	b
p	p
m	m
f	f
d	d
t	t
n	n
l	l
z	z
c	c
s	s
g	g
k	k
h	h
w	w
j	j
a	a
i	i
yu	yu
u	u
e	e
oe	oe
eo	eo
iu	iu
ui	ui
ii	ii
U	U
o	o
aa	aa
M	M
N	N
NG	NG
ng	ng
P	P
T	T
K	K

